111111111111111111111
1C00001CCC000000000C1
1000101000000001C0011
1P0011100000000CCCCE1
111111111111111111111